13 31
###############################
#p     q* *    *  u*  * * *   #
# # # #*# # #*#*# # # #*#*#*# #
#   *     * *  *      *   * * #
# # # # # #*# # #*#*# # # # #*#
#f  4   s  x **  *  *         #
# # # # # # # # # #*# #*# # # #
#w  *      *  *      *        #
# # # # #*# # # #*#*# # # # # #
#*    **  b       *           #
# #*# # # # # # #*# # # # # # #
#           *   *  *          #
###############################