13 31
###############################
#p     ** **   *  *   * * *   #
# # # #*# # #*#*# # # #q#*# # #
#    1    * *  *     1*   * * #
# # # # # #*# # #*#*# # # # #*#
#*         1 **  *  *         #
# # # # # # # # # #*# #*# # # #
#    1     *  *      *   1    #
# # # # #*# # # #*#x# # # # # #
#*  *b*   * 1     **         1#
# # # # # # # # #*# #1# # # # #
#      1    *   *  *          #
###############################