13 31
###############################
#p  **    *     ** * 1        #
# # # #*# # #*# # # # # #*# # #
#  * 2      *   w     *  3    #
# # # # # #*# # #*#*# #*# # #*#
#     *  1 **b*  *  *         #
# #*# # #*# # # # #*# #*# # # #
#*  *     3*  *      *      * #
# # # # #*# #*# #*#*# # # # #*#
#*   1**    *     * 2         #
# #*# # # # # # #*#*# #*# # # #
#     **    *      1   *x*    #
###############################