13 31
###############################
#p     q* *    *  u*  * * *   #
# # # #*# # #*#*# # # #*#*#*# #
#   *   1 * *  *      *   * * #
# # # # # #*# # #*#*# # # # #*#
#f      s  x ** 1*  *   3     #
# # # # # # # # # #*# #*# # # #
#w  *      *  *      *    3   #
# # # # #*# # # #*#*# # # # # #
#*    **  b       * 1    3    #
# #*# # # # # # #*# # # # # # #
#           *   *  *          #
###############################