13 37
#####################################
#        **     ** *       4        #
# # # #*# # #*# # # # # #*# #*# # # #
#*    3     *  2      *   3   **    #
# #*# #*# #*# # #*#*# #*# # #*# #*# #
# 5   *  1   *   w  *    2   *     *#
#x# # # #*# # #*# #*# #*# # # # # #*#
#   * 5   **  *  1   *   4    *  u  #
# # # # #*# #*# #*#*# # # # #*# # # #
#* 5 ***  1      ** 2      **   3   #
# #*# # # # # # #*#w# #*# # # #*#*# #
#   **      *      4   ***         p#
#####################################