13 31
###############################
#p        *     ** * 1        #
#*# # #*# # #*# # # # # #*# # #
#  * 2      *   q     *  1*   #
# # # # # #*# # #*#*# #2# # #*#
#     1    *f**  *  *         #
# #*# # #*# # # # #*# #*# # # #
#*  *     2*  *      *      * #
# # # # #*# #*# #*#*# # # # #*#
#*   1**    *     * 2         #
# #*# # # # # # #*#*# #*# # # #
#     s     *      1   *x*    #
###############################