13 35
###################################
#p  **    *  2  ** *       3  **  #
# # # #*# # #*# # # # # #*# # # # #
#* * 1      *   *     *  4    f   #
# # # # # #*# # #*#*# #*# # #*# # #
#     *  1 **s*  *  *        3    #
# #*# # #*# # #*# #*# #*# # # # # #
#2  *  3  **  *      *      2     #
# # # # #*# #*# #*#*# # # # #*#x# #
#*   4**    *     * 2      **     #
# #*# # # # # # #*#*# #b# # # # # #
#     3     *      1   * *        #
###################################