13 31
###############################
#p     ** *    *   *  * * *   #
# # # #*# # #*#*# # # #*#*#*# #
#   *   1 * *  *      *   * * #
# # # # # #*# # #*#*# # # # #*#
#f         x ** 1*  *         #
# # # # # # # # # #*# #*# # # #
#*  *      *  *      *        #
# # # # #*# # # #*#*# # # # # #
#*    **  b       * 1         #
# #*# # # # # # #*# # # # # # #
#           *   *  *          #
###############################