13 31
###############################
#p  **    *    2** * 1        #
# # # #*# # #*# # # # # #*# # #
#  * 2      *   w     *  3    #
# # # # # #*# # #*#*# #*# # #*#
#  3  *  1 **b*  *  *         #
# #*# # #*# # # # #*# #*# # # #
#*  *     3*  *      *   2  * #
# # # # #*# #*# #*#*# # # # #*#
#*   1**    *     * 2         #
# #*# # # # # # #*#*# #*# # # #
#  3  **    *      1   *x*    #
###############################