13 31
###############################
#p   f* 1    **   *   * * *   #
# #b# #*#*#*#*#*# # # # #*# # #
#s   ** 2    **       *   *x* #
# # # #*#*#*#*# #*#*# # #*# #*#
#w   ** 3    **  *  *         #
# # # #*#*#*#*# # #*# #*# # # #
#q   ** 4    **      *   1   *#
# # # #*#*#*#*# #*# # # #*# # #
#u   ** 5    **   **         1#
# # #*#*#*#*#*# #*# #1# # # # #
#    ** 6    ** *  *     *    #
###############################