13 31
###############################
#p  **    **   2 * *    *  x  #
# # # #*# # # # # # # # #*# # #
#  *     2*     q    3   2    #
# # # # # #*# # #*#*# #*# # #*#
#    1* *    **     *    *    #
# #*# # #*# # # # # #*#*# # # #
#*  *   1  *  *   3*      1* *#
# # # # #b# # # # # #*#*# # #*#
#     **  3 *  *   *2         #
#*#*# # # # # # #*# # #*# # # #
#  3  *      *     1   * *    #
###############################