13 31
###############################
#p    *    1     ***     3    #
# # # # # # # # # # # # # # # #
#b    *          ***          #
#f# # #*#*#*#*#*# # #*#*#*#*#*#
#s                            #
#q# # #*#*#*#*#*# # #*#*#*#*#*#
#w    *    2     ***     4    #
#u# # # # # # # # # # # # # # #
#w    *          ***          #
#u# #*#*#*#*#*#*# # #*#*#*#*#*#
#x                            #
###############################