13 31
###############################
#p     q* *    *  u*  * * *   #
# # # #*# # #*#*# # # #*#*#*# #
#   *   1 * *  *      *   * * #
# # # # # #*# # #*#*# # # # #*#
#f      s  x ** 1*  *         #
# # # # # # # # # #*# #*# # # #
#w  *      *  *      *        #
# # # # #*# # # #*#*# # # # # #
#*    **  b       * 1         #
# #*# # # # # # #*# # # # # # #
#           *   *  *          #
###############################