13 31
###############################
#p     q* *    *  u*  * * *   #
# # # #*# # #*#*# # # #*#*#*# #
#   *     * *  *      *   * * #
# # # # # #*# # #*#*# # # # #*#
#f         x **  *  *         #
# # # # # # # # # #*# #*# # # #
#w         *  *      *    4   #
# # # # #*# # # #*#*# # # # # #
#*  s **  b       *           #
# #*# # # # # # #*# # # # # # #
#           *   *  *          #
###############################