13 35
###################################
#p       **  2  ** * 3        **  #
# # # #*# # #*# # # # # #*# #*# # #
#*b        3*   *     *   4   **  #
# #*# #*# #*# # #*#*# #*# # #*# # #
#     *  1 **s*  *  *    5   *    #
# #u# # #*# # #*# #*# #*# # # # # #
#2  *  3  **  *  1   *      2 **  #
# # # # #*# #*# #*#*# # # # #*#x# #
#* 1 ***    4    ** 2      **     #
# #*# # # # # # #*#w# #*# # # # # #
#   **   3  *      5   ***        #
###################################