13 35
###################################
#   **    *  2  ** *       3  **  #
# # # #*# # #*#*# # # # #*# # # # #
#x * 4      * s *    4*        *  #
# # # # # #*# # #*# #*#*# # #*# # #
#     *  1 *        *        3    #
# #*# # #*# # #*# #*# #*# # # # #*#
#2  *  3   *  *  f     *    2  *  #
# # # # #*# #*# #*#*# # #*# #*# # #
#*   *      *     *    2   **  4  #
# # # #*# # # # #*#*# # # # # # # #
#     3    **      1 *   *       p#
###################################