13 31
###############################
#p     q* *    *   *  * * *   #
# # # #*# # #*#*# # # #*#*#*# #
#   *   1 * *  *    4 *   * * #
# # # # # #*# # #*#*# # # # #*#
#f         x ** 1*  *         #
# # # # # # # # # #*# #*# # # #
#w  *   4  *  *      *        #
# # # # #*# # # #*#*# # # # # #
#*    **  b       * 1         #
# #*# # # # # # #*# # # # # # #
#           *   *  *          #
###############################