13 31
###############################
#p    *         ** *  1       #
#*# # #*# # #*# # # # # #*# # #
# **        *   b     *   *   #
# # # # # #*# # #*#*# # # # #*#
#     1    f **  *  *         #
# # # # # # # # # #*# #*# # # #
#*  *      *  *      *        #
# # # # #*# # # #*#*# # # # # #
#*    **          * 2         #
# #*# # # # # # #*#*# #*# # # #
#     s     *      1   *x*    #
###############################