13 35
###################################
#p       **     ** * 1        **  #
# # # #*# # #*# # # # # #*# #*# # #
#*b        2*   *     *   3   **  #
# #*# #*# #*# # #*#*# #*# # #*# # #
#     *  1 **s*  *  *    5   *    #
# #u# # #*# # #*# #*# #*# # # # # #
#2  *  3  **  *      *      2     #
# # # # #*# #*# #*#*# # # # #*#x# #
#* 1 ***    *     * 2             #
# #*# # # # # # #*#w# #*# # # # # #
#     3     *      5   * *        #
###################################